'833.4 1596.5 1432.0'
'833.4 1596.5 1432.0'
0
'987.6 1692.1 536.0'
'987.6 1692.1 536.0'
0
'491.0 241.1 728.1'
'491.0 241.1 728.1'
0
'1502.5 343.8 280.1'
'1502.5 343.8 280.1'
0
'1598.8 803.9 600.0'
'1598.8 803.9 600.0'
0
'1657.3 353.7 280.1'
'1657.3 353.7 280.1'
0
'327.0 855.9 1432.1'
'327.0 855.9 1432.1'
0
'1783.4 819.0 692.3'
'1783.4 819.0 692.3'
0
'162.3 1604.9 1432.1'
'162.3 1604.9 1432.1'
0
'702.4 257.0 728.1'
'702.4 257.0 728.1'
0
'387.3 1370.6 1432.1'
'387.3 1370.6 1432.1'
0
'439.6 194.9 1432.1'
'439.6 194.9 1432.1'
0
'353.6 415.8 1432.1'
'353.6 415.8 1432.1'
0
'1059.1 326.7 400.1'
'1059.1 326.7 400.1'
0
'289.1 1592.2 152.1'
'289.1 1592.2 152.1'
0
'1318.9 339.6 357.2'
'1318.9 339.6 357.2'
0
'1918.4 352.0 1431.0'
'1918.4 352.0 1431.0'
0
'1100.1 1107.1 528.1'
'1100.1 1107.1 528.1'
0
'655.8 833.7 656.7'
'655.8 833.7 656.7'
0
'1784.1 733.4 1752.1'
'1784.1 733.4 1752.1'
0
'1784.3 1309.2 1752.1'
'1784.3 1309.2 1752.1'
0
'1797.6 1601.7 1752.1'
'1797.6 1601.7 1752.1'
0
'1545.8 1869.2 1725.5'
'1545.8 1869.2 1725.5'
0
'504.7 1848.6 1432.1'
'504.7 1848.6 1432.1'
0
'1091.9 1829.4 1048.1'
'1091.9 1829.4 1048.1'
0
'1456.9 1858.8 1048.1'
'1456.9 1858.8 1048.1'
0
'1216.6 1840.5 528.1'
'1216.6 1840.5 528.1'
0
'1902.0 1630.1 528.1'
'1902.0 1630.1 528.1'
0
'1538.1 1325.9 808.1'
'1538.1 1325.9 808.1'
0
'1923.5 1104.9 1432.1'
'1923.5 1104.9 1432.1'
0
'1615.8 1362.1 1432.1'
'1615.8 1362.1 1432.1'
0
'1909.7 1710.8 1432.1'
'1909.7 1710.8 1432.1'
0
'1101.6 1497.3 528.1'
'1101.6 1497.3 528.1'
0
'1109.1 453.8 1176.1'
'1109.1 453.8 1176.1'
0
'653.1 1387.0 1432.1'
'653.1 1387.0 1432.1'
0
'1545.6 487.1 1176.1'
'1545.6 487.1 1176.1'
0
'1346.8  49.1 744.1'
'1346.8  49.1 744.1'
0
'1103.4 846.4 528.1'
'1103.4 846.4 528.1'
0
'1914.1 1466.6 528.1'
'1914.1 1466.6 528.1'
0
'1579.7 1837.0 528.1'
'1579.7 1837.0 528.1'
0
'1088.7 1366.1 528.1'
'1088.7 1366.1 528.1'
0
'975.3 1581.5 536.1'
'975.3 1581.5 536.1'
0
'1345.2 1856.1 1048.1'
'1345.2 1856.1 1048.1'
0
'947.4 1852.1 1048.1'
'947.4 1852.1 1048.1'
0
'1718.6 1510.9 1432.1'
'1718.6 1510.9 1432.1'
0
'370.8 813.3 720.1'
'370.8 813.3 720.1'
0
'1172.8 286.6 728.1'
'1172.8 286.6 728.1'
0
'1538.3 599.0 728.1'
'1538.3 599.0 728.1'
0
'1606.9 840.9 280.1'
'1606.9 840.9 280.1'
0
'378.8 495.0 728.0'
'378.8 495.0 728.0'
0
'1580.9 1390.5 280.1'
'1580.9 1390.5 280.1'
0
'500.8 564.0 152.1'
'500.8 564.0 152.1'
0
'247.8 1400.7 152.1'
'247.8 1400.7 152.1'
0
'1439.6 824.9 528.1'
'1439.6 824.9 528.1'
0
'172.1 1416.6 1432.1'
'172.1 1416.6 1432.1'
0
'314.3 1189.3 1432.1'
'314.3 1189.3 1432.1'
0
'1063.7 1875.6 1484.5'
'1063.7 1875.6 1484.5'
0
'1788.3 1065.2 1752.1'
'1788.3 1065.2 1752.1'
0
'1788.0 831.3 1752.1'
'1788.0 831.3 1752.1'
0
'1775.7 373.0 1752.1'
'1775.7 373.0 1752.1'
0
'1662.3 125.2 1432.1'
'1662.3 125.2 1432.1'
0
'1571.4 250.3 1176.1'
'1571.4 250.3 1176.1'
0
'1361.8 430.9 1176.1'
'1361.8 430.9 1176.1'
0
'917.3 662.1 1176.1'
'917.3 662.1 1176.1'
0
'970.6 1154.6 1176.1'
'970.6 1154.6 1176.1'
0
'1405.5 1326.0 808.1'
'1405.5 1326.0 808.1'
0
'1771.7 1853.6 528.0'
'1771.7 1853.6 528.0'
0
'386.6 1399.6 152.0'
'386.6 1399.6 152.0'
0
'521.1 1243.1 152.0'
'521.1 1243.1 152.0'
0
'514.3 1069.9 152.0'
'514.3 1069.9 152.0'
0
'499.5 792.0 152.0'
'499.5 792.0 152.0'
0
